0000000000
0999993224
1223992990
0993223990
0000000000