0000000000000000099799000
0999999999999999999299990
0999422259999999999209990
0999209029999999999299990
0990299929999999099299990
0999299942222222222399990
0999299999090999999999990
0990299999999999990999990
0999299999999995222269990
0990299999999992909929990
0999299999999992999029990
0999322222222226999929990
0999909999999999999929990
0999999999009999999929990
0999942222222222222239990
0999929999999999999090990
0999929999999999999999990
0999929999999999999999990
0999929999999999999999990
0009010900000000000000000