0000000000000000000000000
9999999999999999999999999
9999999999999999999999999
1222599942222222222222227
9999299929999999999999999
9999299929999999999999999
0999299932222222222226990
0999299999999999999992990
0999299942222222599992990
0999299929999999299992990
0999299929999999299992990
0999299929999999299992990
0999299932222269299992990
0999299999999929299992990
0999299999999929299992990
0999299999999929299992990
0999422222222239422223990
0999999999999999999999990
0999999999999999999999990
0000000000000000000000000